1 70 72 70 72 70 72 1 1 1 1 1 1 1 1 1 1 1 1 1 1 1 1 1 1 1 1 1 1 1 1 1 1 1 1 1 1 72 70 72 70 72 72 70 72 70 72 70 72 72 70 72 70 72 70 72 72 70 72 70 
72 70 72 1 70 72 70 1 1 1 1 1 1 1 1 1 1 1 1 1 1 1 1 1 1 1 1 1 1 1 1 1 1 1 1 1 1 72 72 70 72 70 72 70 72 72 1 72 70 72 70 72 72 70 72 70 72 70 72 72 
70 72 1 72 1 1 72 1 1 1 1 1 1 1 1 1 1 1 1 1 1 1 1 1 1 1 1 1 1 1 1 1 1 1 1 1 72 70 72 1 1 72 1 72 1 1 1 1 1 70 72 70 72 70 72 72 70 72 70 72 
70 1 1 1 1 70 1 1 1 1 1 1 1 1 1 1 1 1 1 1 1 1 1 1 1 1 1 1 1 1 1 1 1 1 1 72 72 1 1 1 1 72 72 1 1 72 1 72 72 1 72 72 72 72 72 72 72 72 72 72 
72 72 72 1 72 1 1 1 1 1 1 1 1 1 1 1 1 1 1 1 1 1 1 1 1 1 1 1 1 1 1 1 1 1 72 72 72 72 72 1 72 1 1 1 72 72 1 72 72 72 72 72 1 72 72 72 72 72 72 72 
72 72 72 72 72 1 1 1 1 1 1 1 1 1 1 1 1 1 1 1 1 1 1 1 1 1 1 1 1 1 1 1 1 1 72 72 72 1 72 1 72 1 1 1 72 72 1 72 72 1 72 72 72 72 72 72 72 72 72 72 
72 72 72 72 72 72 1 1 1 1 1 1 1 1 1 1 1 1 1 1 1 1 1 1 1 1 1 1 1 1 1 1 1 72 72 72 1 1 1 72 72 72 72 72 72 72 72 1 72 72 72 72 72 72 72 72 72 72 72 72 
72 72 72 72 72 72 1 1 1 1 1 1 1 1 1 1 1 1 1 1 1 1 1 1 1 1 1 1 1 1 1 1 1 72 1 72 1 72 72 72 1 1 72 72 72 72 72 72 72 1 72 72 1 72 72 72 72 72 72 72 
72 72 72 72 72 72 1 1 1 1 1 1 1 1 1 1 1 1 1 1 1 1 1 1 1 1 1 1 1 1 1 1 1 72 72 72 72 1 72 1 1 72 1 1 1 72 72 72 72 72 72 1 72 72 72 72 72 72 72 72 
72 72 72 1 72 72 1 1 1 1 1 1 1 1 1 1 1 1 1 1 1 1 1 1 1 1 1 1 1 1 1 1 1 72 72 72 72 72 72 72 1 1 72 72 72 72 72 72 1 72 72 1 1 72 72 72 72 72 72 72 
72 72 72 72 72 1 1 1 1 1 1 1 1 1 1 1 1 1 1 1 1 1 1 1 1 1 1 1 1 1 1 1 1 72 72 72 72 1 1 72 72 1 72 1 72 72 72 1 72 72 72 72 72 72 72 72 72 72 72 72 
72 72 72 72 1 1 72 1 1 1 1 1 1 1 1 1 1 1 1 1 1 1 1 1 1 1 1 1 1 1 1 1 1 1 1 1 72 1 72 72 1 1 72 72 72 72 72 72 72 72 72 72 72 72 72 72 72 72 72 72 
72 72 72 72 72 72 1 1 1 1 1 1 1 1 1 1 1 1 1 1 1 1 1 1 1 1 1 1 1 1 1 1 1 1 1 72 1 1 1 72 72 72 72 72 72 72 72 72 72 72 72 72 72 72 72 72 72 72 72 72 
72 72 72 72 1 1 72 72 72 72 72 1 1 1 1 1 1 1 1 1 1 1 1 1 1 1 1 1 1 1 1 1 1 1 1 1 1 1 72 72 1 1 72 72 72 72 72 72 72 72 72 72 72 72 72 72 72 72 72 72 
72 72 72 72 72 72 1 1 72 72 72 1 1 1 1 1 1 1 1 1 1 1 72 72 1 72 1 72 72 1 72 72 72 72 1 72 72 72 72 72 1 1 1 72 72 1 72 72 1 72 72 72 72 72 72 72 72 72 72 72 
72 72 72 72 72 72 72 72 72 1 72 1 1 1 1 1 1 1 1 1 1 1 72 72 72 1 1 72 72 1 1 1 1 72 72 72 72 72 72 72 72 72 72 72 72 72 72 72 72 72 72 72 72 72 72 72 72 72 72 72 
72 72 72 72 72 1 1 72 72 72 1 72 1 1 1 1 72 1 72 72 72 72 72 72 1 72 1 1 72 1 1 72 1 1 1 1 1 1 72 72 1 72 72 1 72 72 72 72 72 72 72 72 72 72 72 72 72 72 72 72 
72 72 72 72 72 72 72 1 72 1 72 1 72 1 72 1 1 1 1 1 72 72 72 72 1 72 1 1 72 72 72 72 1 72 1 72 1 1 72 1 72 1 72 72 72 72 72 72 72 72 72 72 72 72 72 72 72 72 72 72 
72 72 72 72 72 72 72 72 72 1 72 72 72 72 72 72 72 72 72 72 72 1 72 72 1 72 72 72 72 1 72 72 1 72 72 72 1 72 72 72 72 1 1 72 1 72 72 72 72 72 72 72 72 72 72 72 72 72 72 72 
72 72 72 72 72 72 72 72 72 72 72 72 72 72 72 72 72 72 72 1 72 72 72 72 1 72 72 72 72 1 72 72 72 72 72 1 72 1 72 72 1 72 72 72 1 72 72 72 72 72 72 72 72 72 72 72 72 72 72 72 
72 72 72 72 72 72 1 1 72 72 72 72 72 72 72 72 72 72 72 72 72 72 72 72 1 72 72 72 72 72 72 72 72 1 72 72 72 72 72 72 72 72 72 72 72 72 72 1 1 72 72 72 72 72 72 72 72 72 72 72 
72 72 72 72 72 72 72 72 1 72 72 72 72 72 72 1 72 72 72 72 72 72 72 72 72 72 72 72 72 72 72 72 72 72 72 72 72 72 72 72 72 72 72 72 72 72 72 72 72 1 72 72 72 72 72 72 72 72 72 72 
72 72 72 72 72 72 72 72 72 72 72 72 1 72 72 72 72 72 72 72 72 72 72 72 72 1 72 1 72 72 72 72 1 72 72 72 72 72 72 72 72 72 72 72 72 72 72 72 72 1 1 72 72 72 72 72 72 72 72 72 
72 72 72 72 72 72 72 72 72 1 72 72 72 72 72 72 1 72 1 72 72 1 72 72 72 72 72 72 1 72 72 72 72 72 72 72 72 72 72 72 72 72 72 72 72 72 72 72 72 72 1 72 72 72 72 72 72 72 72 72 
72 72 72 72 72 72 72 72 72 72 72 72 72 72 72 72 72 72 72 72 72 72 72 72 72 72 72 72 72 72 72 72 72 72 72 72 72 72 72 72 72 72 72 72 72 72 72 72 72 72 1 72 72 72 72 72 72 72 72 72 
72 72 72 72 72 72 72 72 72 72 72 72 72 72 72 72 72 72 72 72 72 72 72 72 72 72 72 72 1 72 72 72 72 72 72 72 72 72 72 72 72 72 72 72 72 72 72 72 72 72 1 72 72 72 72 72 72 72 72 72 
72 72 72 72 72 72 72 72 72 72 72 72 72 72 72 72 72 72 72 72 72 72 72 72 72 72 72 72 72 72 72 72 72 72 72 72 72 72 72 72 72 72 72 72 72 72 72 72 72 72 1 72 72 72 72 72 72 72 72 72 
72 72 72 72 72 72 72 72 72 72 72 72 72 72 72 72 72 72 72 72 72 72 72 72 72 72 72 72 72 72 72 72 72 72 72 72 72 72 72 72 72 72 72 72 72 72 72 72 72 72 1 72 72 72 72 72 72 72 72 72 
72 72 72 72 72 72 72 72 72 72 72 72 72 72 72 72 72 72 72 72 72 72 72 72 72 72 72 72 72 72 72 72 72 72 72 72 72 72 72 72 72 72 72 72 72 72 72 72 72 72 1 72 72 72 72 72 72 72 72 72 
72 72 72 72 72 72 72 72 72 72 72 72 72 72 72 72 72 72 72 72 72 72 72 72 72 72 72 72 72 72 72 72 72 72 72 72 72 72 72 72 72 72 72 72 72 72 72 72 72 72 1 72 72 72 72 72 72 72 72 72 
72 72 72 72 72 72 72 72 72 72 72 72 72 72 72 72 72 72 72 72 72 72 72 72 72 72 72 72 72 72 72 72 72 72 72 72 72 72 72 72 72 72 72 72 72 72 72 72 72 72 1 72 72 72 72 72 72 72 72 72 
72 72 72 72 72 72 72 72 72 72 72 72 72 72 72 72 72 72 72 72 72 72 72 72 72 72 72 72 72 72 72 72 72 72 72 72 72 72 72 72 72 72 72 72 72 72 72 72 72 72 1 1 72 72 72 72 72 72 72 72 
72 72 72 72 72 72 72 72 72 72 72 72 72 72 72 72 72 72 72 72 72 72 72 72 72 72 72 72 72 72 72 72 72 72 72 72 72 72 72 72 72 72 72 72 72 72 72 72 72 72 72 72 72 72 72 72 72 72 72 72 
72 72 72 72 72 72 72 72 72 72 72 72 72 72 72 72 72 72 72 72 72 72 72 72 72 72 72 72 72 72 72 72 72 72 72 72 72 72 72 72 72 72 72 72 72 72 72 72 72 72 72 72 72 72 72 72 72 72 72 72 
