7 1 1 1 23 1 1 1 1 2 6 64 64 64 64 64 64 64 64 64 64 64 22 1 1 30 24 10 11 26 27 1 1 24 27 5 14 13 30 1 1 1 6 22 64 64 64 64 64 64 64 64 64 64 64 31 12 25 21 16 
2 1 1 0 1 1 1 1 30 1 7 25 2 1 20 17 1 65 64 64 64 64 64 64 64 64 64 65 1 12 23 14 21 24 3 13 0 27 2 26 1 1 1 5 14 1 31 1 1 1 1 64 1 64 64 64 64 64 64 64 
11 1 1 1 1 20 1 13 24 2 12 13 20 27 2 1 31 10 0 6 21 14 25 17 65 64 64 65 65 65 64 64 65 3 1 11 30 1 1 1 16 1 1 7 22 6 24 30 1 1 17 1 31 1 22 23 25 12 65 65 
1 1 1 65 65 1 27 1 1 1 20 1 11 16 10 3 13 17 10 1 1 23 26 1 7 0 1 1 31 17 21 2 57 57 1 1 56 3 14 11 12 4 22 1 27 1 30 24 25 10 26 1 3 17 1 1 27 2 0 13 
11 25 1 1 16 12 1 57 56 20 5 1 4 15 21 23 14 7 24 22 10 31 1 31 14 30 1 1 21 12 11 31 1 10 7 24 1 6 27 1 1 55 2 1 1 1 1 1 1 17 20 3 25 23 1 6 1 27 14 3 
11 13 2 21 25 1 7 0 1 16 1 1 47 1 57 10 12 5 23 20 1 31 22 24 30 1 1 1 2 1 27 12 1 0 1 1 10 21 1 1 17 13 24 20 55 1 1 1 17 1 26 12 4 31 10 1 3 24 13 1 
6 20 1 6 22 23 11 2 1 1 25 1 1 1 12 20 1 1 56 1 47 1 15 30 7 22 1 26 1 23 11 5 25 2 1 14 13 1 7 10 1 1 22 1 1 1 25 1 31 1 1 1 1 1 1 17 1 23 2 31 
5 15 12 1 10 22 7 26 0 21 23 14 27 2 30 1 17 12 1 16 3 1 31 25 1 1 1 1 6 16 27 20 1 14 11 30 1 1 24 13 1 21 1 1 1 1 1 30 23 1 25 1 10 0 12 27 31 47 57 1 
54 17 5 24 1 12 1 2 13 7 31 1 25 30 1 1 24 1 11 27 4 21 1 10 15 3 17 25 1 1 1 1 55 1 27 16 1 23 1 1 1 1 1 3 12 24 20 21 2 21 26 1 0 1 1 27 13 17 1 1 
22 1 1 1 1 47 3 10 1 1 31 1 7 11 1 1 20 30 1 1 1 1 1 1 1 31 3 13 7 10 1 0 6 26 1 1 1 1 1 1 11 1 22 1 1 30 21 17 27 1 24 2 23 25 7 4 1 1 1 2 
11 16 1 27 21 0 10 30 1 1 1 31 1 12 23 22 1 1 1 25 20 3 13 17 26 1 24 0 1 3 1 1 23 1 25 1 1 1 12 13 1 30 11 1 1 1 1 20 10 1 21 22 31 17 27 1 15 2 1 1 
1 22 12 7 1 1 1 1 1 1 1 2 1 1 21 1 1 11 3 17 30 13 24 23 1 1 1 26 20 1 1 1 30 10 0 1 1 1 3 30 21 1 1 31 13 1 1 1 12 1 1 26 25 2 1 1 23 22 11 24 
1 1 6 1 1 1 1 11 3 2 21 1 1 1 31 12 30 1 1 1 1 1 24 13 1 1 17 1 1 1 23 22 1 20 1 10 1 1 1 1 1 1 1 1 1 1 1 3 10 1 1 13 23 25 11 1 1 1 31 12 
21 1 2 1 17 30 22 1 1 1 1 1 1 1 12 13 1 20 1 1 1 1 1 1 1 2 3 31 11 1 24 22 1 25 1 1 21 1 1 10 1 1 1 1 30 10 1 13 31 1 1 23 11 1 27 2 7 1 1 17 
1 1 1 1 1 30 21 1 1 20 1 22 3 1 1 1 21 22 10 1 13 31 1 1 1 11 1 27 2 7 1 1 1 1 1 12 1 1 30 21 1 1 20 1 22 3 26 24 1 13 17 1 3 20 1 11 2 25 17 30 
7 31 10 1 1 1 1 23 1 13 12 1 1 1 21 22 1 27 1 26 1 0 12 1 1 10 21 1 1 24 30 1 1 26 3 1 17 1 1 1 1 1 11 2 22 7 23 1 13 12 20 1 1 27 0 1 27 0 0 0 
0 0 0 0 0 0 0 0 0 0 0 0 0 0 0 0 0 0 0 0 0 0 0 0 0 0 0 0 0 0 0 0 0 0 0 0 0 0 0 0 0 0 0 0 0 0 0 0 0 0 0 0 0 0 0 0 0 0 0 0 
0 0 0 0 0 0 0 0 0 0 0 0 0 0 0 0 0 0 0 0 0 0 0 0 0 0 0 0 0 0 0 0 0 0 0 0 0 0 0 0 0 0 0 0 0 0 0 0 0 0 0 0 0 0 0 0 0 0 0 0 
0 0 0 0 0 0 0 0 0 0 0 0 0 0 0 0 0 0 0 0 0 0 0 0 0 0 0 0 0 0 0 0 0 0 0 0 0 0 0 0 0 0 0 0 0 0 0 0 0 0 0 0 0 0 0 0 0 0 0 0 
0 0 0 0 0 0 0 0 0 0 0 0 0 0 0 0 0 0 0 0 0 0 0 0 0 0 0 0 0 0 0 0 0 0 0 0 0 0 0 0 0 0 0 0 0 0 0 0 0 0 0 0 0 0 0 0 0 0 0 0 
0 0 0 0 0 0 0 0 0 0 0 0 0 0 0 0 0 0 0 0 0 0 0 0 0 0 0 0 0 0 0 0 0 0 0 0 0 0 0 0 0 0 0 0 0 0 0 0 0 0 0 0 0 0 0 0 0 0 0 0 
0 0 0 0 0 0 0 0 0 0 0 0 0 0 0 0 0 0 0 0 0 0 0 0 0 0 0 0 0 0 0 0 0 0 0 0 0 0 0 0 0 0 0 0 0 0 0 0 0 0 0 0 0 0 0 0 0 0 0 0 
0 0 0 0 0 0 0 0 0 0 0 0 0 0 0 0 0 0 0 0 0 0 0 0 0 0 0 0 0 0 0 0 0 0 0 0 0 0 0 0 0 0 0 0 0 0 0 0 0 0 0 0 0 0 0 0 0 0 0 0 
0 0 0 0 0 0 0 0 0 0 0 0 0 0 0 0 0 0 0 0 0 0 0 0 0 0 0 0 0 0 0 0 0 0 0 0 0 0 0 0 0 0 0 0 0 0 0 0 0 0 0 0 0 0 0 0 0 0 0 0 
0 0 0 0 0 0 0 0 0 0 0 0 0 0 0 0 0 0 0 0 0 0 0 0 0 0 0 0 0 0 0 0 0 0 0 0 0 0 0 0 0 0 0 0 0 0 0 0 0 0 0 0 0 0 0 0 0 0 0 0 
0 0 0 0 0 0 0 0 0 0 0 0 0 0 0 0 0 0 0 0 0 0 0 0 0 0 0 0 0 0 0 0 0 0 0 0 0 0 0 0 0 0 0 0 0 0 0 0 0 0 0 0 0 0 0 0 0 0 0 0 
0 0 0 0 0 0 0 0 0 0 0 0 0 0 0 0 0 0 0 0 0 0 0 0 0 0 0 0 0 0 0 0 0 0 0 0 0 0 0 0 0 0 0 0 0 0 0 0 0 0 0 0 0 0 0 0 0 0 0 0 
0 0 0 0 0 0 0 0 0 0 0 0 0 0 0 0 0 0 0 0 0 0 0 0 0 0 0 0 0 0 0 0 0 0 0 0 0 0 0 0 0 0 0 0 0 0 0 0 0 0 0 0 0 0 0 0 0 0 0 0 
0 0 0 0 0 0 0 0 0 0 0 0 0 0 0 0 0 0 0 0 0 0 0 0 0 0 0 0 0 0 0 0 0 0 0 0 0 0 0 0 0 0 0 0 0 0 0 0 0 0 0 0 0 0 0 0 0 0 0 0 
0 0 0 0 0 0 0 0 0 0 0 0 0 0 0 0 0 0 0 0 0 0 0 0 0 0 0 0 0 0 0 0 0 0 0 0 0 0 0 0 0 0 0 0 0 0 0 0 0 0 0 0 0 0 0 0 0 0 0 0 
0 0 0 0 0 0 0 0 0 0 0 0 0 0 0 0 0 0 0 0 0 0 0 0 0 0 0 0 0 0 0 0 0 0 0 0 0 0 0 0 0 0 0 0 0 0 0 0 0 0 0 0 0 0 0 0 0 0 0 0 
0 0 0 0 0 0 0 0 0 0 0 0 0 0 0 0 0 0 0 0 0 0 0 0 0 0 0 0 0 0 0 0 0 0 0 0 0 0 0 0 0 0 0 0 0 0 0 0 0 0 0 0 0 0 0 0 0 0 0 0 
0 0 0 0 0 0 0 0 0 0 0 0 0 0 0 0 0 0 0 0 0 0 0 0 0 0 0 0 0 0 0 0 0 0 0 0 0 0 0 0 0 0 0 0 0 0 0 0 0 0 0 0 0 0 0 0 0 0 0 0 
0 0 0 0 0 0 0 0 0 0 0 0 0 0 0 0 0 0 0 0 0 0 0 0 0 0 0 0 0 0 0 0 0 0 0 0 0 0 0 0 0 0 0 0 0 0 0 0 0 0 0 0 0 0 0 0 0 0 0 0 
